12 15 1 1 12 15
0 1 0 1 0 1 0 0 0 0 0 0 0 0 0 
0 1 0 0 0 1 0 1 0 1 1 1 1 0 1 
0 1 0 1 0 1 0 1 1 1 0 0 0 0 0 
0 1 0 1 0 1 0 0 1 0 0 1 0 0 0 
0 1 0 1 0 1 0 1 1 1 1 1 0 0 0 
0 1 0 1 0 1 0 1 0 0 0 0 0 1 1 
0 1 0 1 0 0 0 1 0 1 1 1 1 1 0 
0 1 0 0 1 0 0 1 0 1 0 0 0 1 0 
0 1 1 0 1 0 0 1 0 1 0 1 0 1 0 
0 1 0 0 0 1 0 1 0 1 0 1 0 1 0 
0 1 0 1 1 1 1 1 0 1 0 1 0 1 0 
0 0 0 1 0 0 0 0 0 0 0 1 0 0 0 
